NO ./texture/brick/brick_1a.xpm

SO ./texture/brick/brick_2b.xpm

WE ./texture/brick/brick_3b.xpm

EA ./texture/brick/brick_4a.xpm

F 126,64,37
C 115,110,110

     11111111111111
     10000100000001
     10001111000111
     100001000001
  111100N00101111
  100000000000001
  101111111110001
  100001100000001
1111000000000111
   11111111111
