NO ./texture/tech/tech_1c.xpm

SO ./texture/tech/tech_1e.xpm

WE ./texture/tech/tech_2f.xpm

EA ./texture/tech/tech_4f.xpm

F 115,110,110
C 204,174,97

   111111111111
   100000000001
111100001110011
   10000100001
11110101100111
100000000001
10000000W001
100101000001
100000001111
111111111