NO ./texture/blue_stone.xpm

SO ./texture/color_stone.xpm

WE ./texture/grey_stone.xpm

EA ./texture/purple_stone.xpm

F 51,0,0
C 0,0,225

1111111111111111111111111
1000000000110000000000001
1011000001110000000000001
1001000000000000000000001
111000111011000001110000000000001
100000000011000001110111111111111
111101111111110000000010001
11110111111111000001010010001
11000000110101000000000010001
10000000000000001100000000001
10000000000000001101010000001
11000001110101011111011100N0111
11110111 1110101 101111010001
11111111 1111111 111111111111