11111111111111111111111111111111111111111111111111
10000000000000011111111100000000111111110000000001
10000000000000000000000100000000100000010000000001
11111111111111110000000111111111100000010000000001
10000000100000010000000000000000100000011111111101
10000000111111111111111100000000111111110000000001
10000000000000010000000100000000100000010000000001
11111111111111111111111000000001111111111111111101
10000000000000000000000000000000000000000000000001
10000000111111111111111111111111111111110000000001
10000000100000010000000000000000000000000000000001
10000000111111110000000111111100111111110000000001
10000000000000010000000100000000100000010000000001
11111111111111111100011100000000111111111111111101
10000000000000000000000011111111000000010000000001
10000000111111111111111110000000111111110000000001
10000000100000010000000100000000100000010000000001
10000000111111111111111100000000111111110000000001
10000000000000010000000111111111100000010000000001
11111100100000010000000100000000100000011111111101
10000000111111111111111111111111111111110000000001
10000000000000000000000000000000000000010000000001
11111111111111111110001111111111111111111111111101
10000000000000010000000000000000000000000000000001
10000000111111110000000111111100111111110000000001
10000000100000010000000100000000100000010000000001
10000000111111111111111100000000111111111110011101
10000000000000010000000100000000100000010000000001
11111111111111111111111111111111111111111100001111
10000000000000000000000000000000000000000000000001
10000000111111111111111111111111111111110000000001
10000000100000010000000000000000000000010000000001
10000000111111110000000111111100111111110000000001
10000000000000010000000100000000100000010000000001
11111111111111111111110000000000111111111111111101
10000000000000000000000011111111000000010000000001
10000000111111111111111110000000111111110000000001
100000001000000100000001000000001000000100000N0001
10000000111111111111111100000000111111110000000001
11111111111111111111111111111111111111111111111111
