1111111111111111111111111111111111111111111111111111111111111111111111111111111111111111111111111111
1000000000000001111111110000000011111111000000000110000000000000000000000100000000100000010000000001
1111111111111111000000011111111110000001000000000110000000100000010000000000000000100000011111111101
1000000011111111111111110000000011111111000000000110000000000000010000000100000000100000010000000001
1111111111111111111111100000000111111111111111110110000000000000000000000000000000000000000000000001
1000000011111111111111111111111111111111000000000110000000100000010000000000000000000000000000000001
1000000011111111000000011111110011111111000000000110000000000000010000000100000000100000010000000001
1111111111111111110001110000000011111111111111110110000000000000000000000011111111000000010000000001
1000000011111111111111111000000011111111000000000110000000100000010000000100000000100000010000000001
1000000011111111111111110000000011111111000000000110000000000000010000000111111111100000010000000001
1111110010000001000000010000000010000001111111110110000000111111111111111111111111111111110000000001
1000000000000000000000000000000000000001000000000111111111111111111110001111111111111111111111111101
1000000000000001000000000000000000000000000000000110000000111111110000000111111100111111110000000001
1000000010000001000000010000000010000001000000000110000000111111111111111100000000111111111110011101
1000000000000001000000010000000010000001000000000111111111111111111111111111111111111111111100001111
1000000000000000000000000000000000000000000000000110000000111111111111111111111111111111110000000001
1000000010000001000000000000000000000001000000000110000000111111110000000111111100111111110000000001
1111111111111111111111000000000011111111111111110110000000000000010000000100000000100000010000000001
1000000000000000000000001111111100000001000000000110000000111111111111111110000000111111110000000001
100000001000000100000001000000001000000100000N000110000000111111111111111100000000111111110000000001
1111111111111111111111111111111111111111111111111111111111111111111111111111111111111111111111111111
