NO ./texture/blue_stone.xpm

SO ./texture/color_stone.xpm

WE ./texture/grey_stone.xpm

EA ./texture/purple_stone.xpm

F 100, 71, 63
C 74, 88, 124

1111111111111111111111111
1000000000110000000000001
1011000001110000000000001
1001000000000000000000001
1110001110110000011100001
1000000000110000011101111
1111011111111100000000111
11110111111111000001010011111
11000000110101000000000010001
10000000000000001100000000001
10000000000000001101010000011
11000001110101011111011100N0111
11110111 1110101 101111010001
11111111 1111111 111111111111
