NO ./texture/wolf/green_stone.xpm

SO ./texture/wolf/color_stone.xpm

WE ./texture/wolf/grey_stone.xpm

EA ./texture/wolf/purple_stone.xpm

F 24,40,37
C 109,142,160

      11111111111111
      100000000000001
     1100001111100001
     100001000100001
 111110000100000111
 111110000100S00111
 111110000100000111
 110000000000000001
 110111111011111001
 110000001000001001
111100000000000111
   1111111111111
